type octile
height 36
width 64
map
TTTTTTTTTTTTTTTTTTTTTTTTTTTTTTTTTTTTTTTTTTTTTTTTTTTTTTTTTTTTTTTT
T........T........T............................................T
T..TTTT..T..TTTTTTT..TTTTTTTTTTTTTTTTTTTTTTTTTTTT..TTTTTTTTTT..T
T...........T........T.....T....................T.....T........T
T.....T.....T........T.....T....................T.....T........T
TTTT..T..TTTT..TTTTTTT..T..T..T..T..TTTTTTTTTT..TTTT..T..TTTT..T
T.....T..T.....T........T.....T...........T..T..T.....T........T
T..TTTT..T..TTTT..TTTTTTTTTTTTT..TTTT..TTTTTTT..TTTTTTTTTT..TTTT
T..T.....T..T..T..T..............T..T..T.....T...........T.....T
T..T.....T..T..T..T..............T..T..T.....T........T........T
T..TTT..TT..TTTT..T..TTTTTTTTTT..T..T..T..T..TTTT..T..TTTTTTT..T
T........T..T.....T.....T.....T..T..T.....T.....T..T...........T
T..TTTT..T..T..TTTTTTT..TTTT..T..TTTTTTTTTTTTT..T..TTTTTTTTTTTTT
T..T........T..............T..T.............................T..T
T..T..TTTT..TTTTT.TTTTTTT..T..T..TTTTTTTTTT..T..TTTT..TTTT..TTTT
T..T..T....................T.................T.....T..T..T.....T
T..T..T....................T.................T.....T..T..T.....T
T..T..T..TTTTTTTTTTTTTT.TTTT..............TT.TTTT..T..T..TTTT..T
T...........T.....T.............................T..T.....T.....T
T..TTTTTTT..T..T..T..TTTT..TTTTTTT..TTTTTTT..T..T..TTTT..T..TTTT
T..T........T..T..T.....T...........T........T.....T..T..T.....T
T..T........T..T..T.....T........T..T........T.....T..T........T
T..T..TTTTTTT..T..TTTT..T..TTTTTTTTTT..TTTTT.TTTT.....T..TTTT..T
T..T..T........T.....T..T...........T...........T........T..T..T
T..T..T..TTTTTTTTTT..T..TTTT..T..TTTTTTT..TTTT..T..TTTTTTTTTT..T
T..T.......................T..T.....T..T..T.....T........T..T..T
T..T.......................T..T.....T..T..T.....T........T..T..T
T..T..TTTTTTTTTTTTTTTTTTTTTT..TTTT..TTTT..T..TTTTTTTTTT..TTTT..T
T...........T.....T...........T..T..T..T..............T..T.....T
TTTTTTTTTT..T..T..T..T..TTTT..TTTT..TTTT..TTTT..TTTTTTT..T..TTTT
T.....T.....T..T..T..T..T..T..............T.....T.....T..T.....T
T..TTTT..TTTT..T..T..T..TTTTTTTTTTTTTTTT..T..TTTT..T..T..TTTTTTT
T...........T.....T..T.................T..T..T.....T..T........T
TTTTTTTTTT..TTTT..T..TTTTTTTTTTTTTTTT..T..T..TTTTTTTTTTTTTTTT..T
T....................T.................T.......................S
TTTTTTTTTTTTTTTTTTTTTTTTTTTTTTTTTTTTTTTTTTTTTTTTTTTTTTTTTTTTTTTT